%%%%%%%%%%%%%%%%%%%%%%%%%%%%%%%%%%%%%%%%%%%%%%%%%%%%%%%%%%%%%
%S    %       %             %         %     %           %   %
%%% %%% % %%%%% %%%%% %%%%% %%% %%%%%%% % %%% % %%%%%%% % %%%
%   %         %   % %   % %   %         %   % %     % % %   %
% %%% %%% %%% %%% % %%% % %%% % %%%%%% %%%% % %%%%% % % %%% %
% %   % %   % %   %   % %                 % %   % % %       %
%   %%% % % % % % % % % %%% % %%%%%%% %%% % %%% % % %%%%%%% %
% %   %   % %   %   % %   % %     %   %   %     % %   %   % %
%.%%%%%%% % % %%% %%% %%% % %%% %%% % % %%%%%%%%% %%% % % % %
%   %   % %       % % %   %   % %   % % %     %     %   % % %
% % %%% % %%% %%%%% % % %%%%% % % %%% % % %%% %%%%% %%%%% %%%
% %   % %   %         % %   % %     %   % % %           %   %
% %%%%% %%%%% %%%%% %%% % % % %%%%%%%%% % % %%% %%% %%% %%% %
%     %       %         % % %         %   %     %     %   % %
% %%% %%% %%%%% %%%%% % %%% %%% %%%%% %%%%%% %%%% %%% %%% % %
%   %     %     %   % %         % % %   %     %   %     % % %
% % %%% %%% %%% %%% % %%% %%%% %% % %%% % %%% % %%% %%% %%% %
% %   %   %       %       %       %   %   % % % %     %   % %
% % %%% % %%%% %% %%%%%%%%% %%%%% %%% % %%% % % % % %%%%% % %
% %     %   %     %       %   %       %     %   % % %   % % %
% %%%% %% % % %%%%% %%%%% %%% % %%%% %% %%% %% %% %%% % % % %
%         % %           %     %           %           % %  E%
%%%%%%%%%%%%%%%%%%%%%%%%%%%%%%%%%%%%%%%%%%%%%%%%%%%%%%%%%%%%%
