%%%%%%%%%%%%%%%%%%%%%%%%%%%%%%%%%%%%%%%%%%%%%%%%%%%%%%%%%%%%%
%S    %       %             %         %     %           %   %
%%% %%% % %%%%% %%%%% %%%%% %%% %%%%%%% % %%% % %%%%%%% % %%%
%   %         %   % %   % %   %         %   % %     % % %   %
% %%% %%% %%% %%% % %%% % %%% % %%%%%% %%%% % %%%%% % % %%% %
% %   % %   % %   %   % %                 % %   % % %       %
%   %%% % % % % % % % % %%% % %%%%%%% %%% % %%% % % %%%%%%% %
% %   %   % %   %   % %   % %     %   %   %     % %   %   % %
% %%%%%%% % % %%% %%% %%% % %%% %%% % % %%%%%%%%% %%% % % % %
%   %   % %       % % %   %   % %   % % %     %     %   % % %
% % %%% % %%% %%%%% % % %%%%% % % %%% % % %%% %%%%% %%%%% %%%
% %   % %   %         % %   % %     %   % % %           %   %
% %%%%% %%%%% %%%%% %%% % % % %%%%%%%%% % % %%% %%% %%% %%% %
%     %       %         % % %    .    %   %     %     %   % %
% %%% %%% %%%%% %%%%% % %%% %%% %%%%% %%%%%% %%%% %%% %%% % %
%   %     %     %   % %         % % %   %     %   %     % % %
% % %%% %%% %%% %%% % %%% %%%% %% % %%% % %%% % %%% %%% %%% %
% %   %   %       %       %       %   %   % % % %     %   % %
% % %%% % %%%% %% %%%%%%%%% %%%%% %%% % %%% % % % % %%%%% % %
% %     %   %     %       %   %       %     %   % % %   % % %
% %%%% %% % % %%%%% %%%%% %%% % %%%% %% %%% %% %% %%% % % % %
%         % %           %     %           %           % %  E%
%%%%%%%%%%%%%%%%%%%%%%%%%%%%%%%%%%%%%%%%%%%%%%%%%%%%%%%%%%%%%
