%%%%%%%%%%%
%S%    .  %
% % %%%%% %
% % %   % %
% % % % %%%
% %   %   %
% %%%%%%% %
% % %     %
% % % % %%%
%     %  E%
%%%%%%%%%%%
