%%%%%%%%%%%
%S%       %
% % %%%%% %
% % %   % %
% % % % %%%
%.%   %   %
% %%%%%%% %
% % %     %
% % % % %%%
%     %  E%
%%%%%%%%%%%
