%%%%%%%%%%%
%S%       %
% % %%%%% %
%.% %   % %
% % % % %%%
% %   %   %
% %%%%%%% %
% % %     %
% % % % %%%
%     %  E%
%%%%%%%%%%%
