%%%%%%%%%%%
%S%       %
% % %%%%% %
% % %   % %
% % % % %%%
% %   %   %
%.%%%%%%% %
% % %     %
% % % % %%%
%     %  E%
%%%%%%%%%%%
