%%%%%%%%%%%
%S%       %
% % %%%%% %
% % %   % %
% % % % %%%
% %   %   %
% %%%%%%% %
% % %    .%
% % % % %%%
%     %  E%
%%%%%%%%%%%
