%%%%%%%%%%%
%S%       %
% % %%%%% %
% % %   % %
% % % % %%%
% %   %   %
% %%%%%%% %
% % %     %
% % % % %%%
%   . %  E%
%%%%%%%%%%%
